000000012242215555595555512242211111111112211112242211111111
055555512242215555595555512242211111111112211112242211111111
055555512242215555999555512242211111111112211112242211111111
055555512242219999999999912242222222211112211112242211111111
055555512242215555999555512242222222211112211112242211111111
055555512242215555595555512242211111111112211112242211111111
055555512242215555595555512242211111111112211112242211111111
111111117777711111111111117777711111111117711117777711111111
222222262222262222222222262222262222222222222262222262222222
222222262222262222222222262222262222222222222262222262222222
333333362222263333333333362222263333333333333362222263333333
222222262222262222222222262222262222222222222262222262222222
222222262222262222222222262222262222222222222262222262222222
111111117777711111111111117777711117711117711117777711111111
888855512242215555555555512242215552255552255512242215599555
088885512242215555555555512242215552255552255512242215599555
008885512242215555555555512242215552255552255512242215599555
000888512242215550000055512242215552255552255512242215900955
000088512242215550000055512242215552255552255512242219000099
000008512242215550000055512242215552255552255512242219000099
000000812242215550000055512242215552255552255512242215900955
000000812242215555555555512242215552255552255512242215599555
000008512242215555555555512242215552255552255512242215599555
888885512242215555555555512242215552255552255512242215599555
111111117777711111111111117777711117711117711117777711111111
222222262222262222222222262222262222222222222262222262222222
222222262222262222222222262222262222222222222262222262222222
333333362222263333333333362222263333333333333362222263333333
222222262222262222222222262222262222222222222262222262222222
222222262222262222222222262222262222222222222262222262222222
111111117777711111111111117777711111111111111117777711111111
555555512242215555555555512242211111111111111112242215555555
555555512242215555500000512242211111111111111112242215555555
555555512242215555555555512242211111111111111112242215555555
555555512242215555555222222242211111111111111112242215555555
555555512242215555555222222242211111111111111112242215555555