5,5,5,5,5,5,5,1,2,2,4,2,2,1,10,5,10,5,10,9,5,5,10,10,5,1,2,2,4,2,2,1,1,1,1,1,1,1,1,1,1,2,2,1,1,1,1,2,2,4,2,2,1,1,1,1,1,1,1,1
5,5,5,5,10,5,5,1,2,2,4,2,2,1,5,10,10,5,5,9,5,10,5,5,10,1,2,2,4,2,2,1,1,1,1,1,1,1,1,1,1,2,2,1,1,1,1,2,2,4,2,2,1,1,1,1,1,1,1,1
5,5,5,5,5,5,5,1,2,2,4,2,2,1,10,5,5,10,9,9,9,5,10,5,10,1,2,2,4,2,2,1,1,1,1,1,1,1,1,1,1,2,2,1,1,1,1,2,2,4,2,2,1,1,1,1,1,1,1,1
5,5,5,5,5,5,5,1,2,2,4,2,2,1,9,9,9,9,9,9,9,9,9,9,9,1,2,2,4,2,2,2,2,2,2,2,2,1,1,1,1,2,2,1,1,1,1,2,2,4,2,2,1,1,1,1,1,1,1,1
5,5,5,5,5,5,5,1,2,2,4,2,2,1,10,5,5,5,9,9,9,5,5,5,10,1,2,2,4,2,2,2,2,2,2,2,2,1,1,1,1,2,2,1,1,1,1,2,2,4,2,2,1,1,1,1,1,1,1,1
5,5,10,5,5,10,5,1,2,2,4,2,2,1,5,10,10,5,5,9,5,10,5,10,5,1,2,2,4,2,2,1,1,1,1,1,1,1,1,1,1,2,2,1,1,1,1,2,2,4,2,2,1,1,1,1,1,1,1,1
5,5,5,5,5,5,5,1,2,2,4,2,2,1,10,5,10,5,10,9,10,5,10,5,10,1,2,2,4,2,2,1,1,1,1,1,1,1,1,1,1,2,2,1,1,1,1,2,2,4,2,2,1,1,1,1,1,1,1,1
1,1,1,1,1,1,1,1,7,7,7,7,7,1,1,1,1,1,1,1,1,1,1,1,1,1,7,7,7,7,7,1,1,1,1,1,1,1,1,1,1,7,7,1,1,1,1,7,7,7,7,7,1,1,1,1,1,1,1,1
2,2,2,2,2,2,2,6,2,2,2,2,2,6,2,2,2,2,2,2,2,2,2,2,2,6,2,2,2,2,2,6,2,2,2,2,2,2,2,2,2,2,2,2,2,2,6,2,2,2,2,2,6,2,2,2,2,2,2,2
2,2,2,2,2,2,2,6,2,2,2,2,2,6,2,2,2,2,2,2,2,2,2,2,2,6,2,2,2,2,2,6,2,2,2,2,2,2,2,2,2,2,2,2,2,2,6,2,2,2,2,2,6,2,2,2,2,2,2,2
3,3,3,3,3,3,3,6,2,2,2,2,2,6,3,3,3,3,3,3,3,3,3,3,3,6,2,2,2,2,2,6,3,3,3,3,3,3,3,3,3,3,3,3,3,3,6,2,2,2,2,2,6,3,3,3,3,3,3,3
2,2,2,2,2,2,2,6,2,2,2,2,2,6,2,2,2,2,2,2,2,2,2,2,2,6,2,2,2,2,2,6,2,2,2,2,2,2,2,2,2,2,2,2,2,2,6,2,2,2,2,2,6,2,2,2,2,2,2,2
2,2,2,2,2,2,2,6,2,2,2,2,2,6,2,2,2,2,2,2,2,2,2,2,2,6,2,2,2,2,2,6,2,2,2,2,2,2,2,2,2,2,2,2,2,2,6,2,2,2,2,2,6,2,2,2,2,2,2,2
1,1,1,1,1,1,1,1,7,7,7,7,7,1,1,1,1,1,1,1,1,1,1,1,1,1,7,7,7,7,7,1,1,1,1,7,7,1,1,1,1,7,7,1,1,1,1,7,7,7,7,7,1,1,1,1,1,1,1,1
8,8,8,8,8,8,8,1,2,2,4,2,2,1,10,5,10,5,5,5,5,5,10,5,10,1,2,2,4,2,2,1,5,5,5,2,2,5,5,5,5,2,2,5,5,5,1,2,2,4,2,2,1,5,5,9,9,5,5,5
0,8,8,8,8,8,8,1,2,2,4,2,2,1,5,10,5,5,5,5,5,5,5,10,5,1,2,2,4,2,2,1,5,10,5,2,2,5,10,10,5,2,2,5,10,5,1,2,2,4,2,2,1,5,5,9,9,5,5,5
0,0,8,8,8,8,8,1,2,2,4,2,2,1,10,5,10,5,5,5,5,5,10,5,10,1,2,2,4,2,2,1,5,5,5,2,2,5,5,5,5,2,2,5,5,5,1,2,2,4,2,2,1,5,5,9,9,5,5,5
0,0,0,8,8,8,8,1,2,2,4,2,2,1,5,5,5,0,0,0,0,0,5,5,5,1,2,2,4,2,2,1,5,10,5,2,2,5,10,10,5,2,2,5,10,5,1,2,2,4,2,2,1,5,9,0,0,9,5,5
0,0,0,0,8,8,8,1,2,2,4,2,2,1,5,5,5,0,0,0,0,0,5,5,5,1,2,2,4,2,2,1,5,5,5,2,2,5,5,5,5,2,2,5,5,5,1,2,2,4,2,2,1,9,0,0,0,0,9,9
0,0,0,0,8,8,8,1,2,2,4,2,2,1,5,5,5,0,0,0,0,0,5,5,5,1,2,2,4,2,2,1,5,10,5,2,2,5,10,10,5,2,2,5,10,5,1,2,2,4,2,2,1,9,0,0,0,0,9,9
0,0,0,0,8,8,8,1,2,2,4,2,2,1,5,5,5,0,0,0,0,0,5,5,5,1,2,2,4,2,2,1,5,5,5,2,2,5,5,5,5,2,2,5,5,5,1,2,2,4,2,2,1,5,9,0,0,9,5,5
0,0,0,8,8,8,8,1,2,2,4,2,2,1,10,5,10,5,5,5,5,5,10,5,10,1,2,2,4,2,2,1,5,10,5,2,2,5,10,10,5,2,2,5,10,5,1,2,2,4,2,2,1,5,5,9,9,5,5,5
0,0,8,8,8,8,8,1,2,2,4,2,2,1,5,10,5,5,5,5,5,5,5,10,5,1,2,2,4,2,2,1,5,5,5,2,2,5,5,5,5,2,2,5,5,5,1,2,2,4,2,2,1,5,5,9,9,5,5,5
0,8,8,8,8,8,8,1,2,2,4,2,2,1,10,5,10,5,5,5,5,5,10,5,10,1,2,2,4,2,2,1,5,10,5,2,2,5,10,10,5,2,2,5,10,5,1,2,2,4,2,2,1,5,5,9,9,5,5,5
1,1,1,1,1,1,1,1,7,7,7,7,7,1,1,1,1,1,1,1,1,1,1,1,1,1,7,7,7,7,7,1,1,1,1,7,7,1,1,1,1,7,7,1,1,1,1,7,7,7,7,7,1,1,1,1,1,1,1,1
2,2,2,2,2,2,2,6,2,2,2,2,2,6,2,2,2,2,2,2,2,2,2,2,2,6,2,2,2,2,2,6,2,2,2,2,2,2,2,2,2,2,2,2,2,2,6,2,2,2,2,2,6,2,2,2,2,2,2,2
2,2,2,2,2,2,2,6,2,2,2,2,2,6,2,2,2,2,2,2,2,2,2,2,2,6,2,2,2,2,2,6,2,2,2,2,2,2,2,2,2,2,2,2,2,2,6,2,2,2,2,2,6,2,2,2,2,2,2,2
3,3,3,3,3,3,3,6,2,2,2,2,2,6,3,3,3,3,3,3,3,3,3,3,3,6,2,2,2,2,2,6,3,3,3,3,3,3,3,3,3,3,3,3,3,3,6,2,2,2,2,2,6,3,3,3,3,3,3,3
2,2,2,2,2,2,2,6,2,2,2,2,2,6,2,2,2,2,2,2,2,2,2,2,2,6,2,2,2,2,2,6,2,2,2,2,2,2,2,2,2,2,2,2,2,2,6,2,2,2,2,2,6,2,2,2,2,2,2,2
2,2,2,2,2,2,2,6,2,2,2,2,2,6,2,2,2,2,2,2,2,2,2,2,2,6,2,2,2,2,2,6,2,2,2,2,2,2,2,2,2,2,2,2,2,2,6,2,2,2,2,2,6,2,2,2,2,2,2,2
1,1,1,1,1,1,1,1,7,7,7,7,7,1,1,1,1,1,1,1,1,1,1,1,1,1,7,7,7,7,7,1,1,1,1,1,1,1,1,1,1,1,1,1,1,1,1,7,7,7,7,7,1,1,1,1,1,1,1,1
5,5,5,5,5,5,5,1,2,2,4,2,2,1,5,5,5,5,5,5,5,5,5,5,5,1,2,2,4,2,2,1,1,1,1,1,1,1,1,1,1,1,1,1,1,1,1,2,2,4,2,2,1,5,5,5,5,5,5,5
5,5,5,5,5,5,5,1,2,2,4,2,2,1,5,5,5,5,5,0,0,0,0,0,5,1,2,2,4,2,2,1,1,1,1,1,1,1,1,1,1,1,1,1,1,1,1,2,2,4,2,2,1,5,5,5,5,5,5,5
5,5,5,5,5,5,5,1,2,2,4,2,2,1,5,5,5,5,5,5,5,5,5,5,5,1,2,2,4,2,2,1,1,1,1,1,1,1,1,1,1,1,1,1,1,1,1,2,2,4,2,2,1,5,5,5,5,5,5,5
5,5,5,5,5,5,5,1,2,2,4,2,2,1,5,5,5,5,5,5,5,2,2,2,2,2,2,2,4,2,2,1,1,1,1,1,1,1,1,1,1,1,1,1,1,1,1,2,2,4,2,2,1,5,5,5,5,5,5,5
5,5,5,5,5,5,5,1,2,2,4,2,2,1,5,5,5,5,5,5,5,2,2,2,2,2,2,2,4,2,2,1,1,1,1,1,1,1,1,1,1,1,1,1,1,1,1,2,2,4,2,2,1,5,5,5,5,5,5,5
