000000000000000000000000000000000000000000000000000000000000000000000000000000
222222222222222222222222222222222222222222222222222222222222222222222222222222
222222222222222222222222222222222222222222222222222222222222222222222222222222
222222222222222222222222222222222222222222222222222222222222222222222222222222
222222222222222222222222222222222222222222222222222222222222222222222222222222
111111111111111111111111111111111111111111111111111111111111111111111111111111
333333333333333333444444444444444433333333333333333333333334444444444333333333